------   --------
|....|   |...!..|    ------
|.@..+###+....*.|    |..j.|
|....|   |......|    |....|
------   |......+####+....=
         ---+----    ------
            #
          --+--
          |...|
          -----