------   --------
|....|   |...!..|    ------
|.@..+###+....*.|    |..j.|
|....|   |......|    |....|
------   |......+####+....|
         ---+----    ------
            #
          --+--
          |..=|
          -----