------   --------
|....|   |...!..|    ------
|.@..+###+......|    |..j.|
|....|   |......|    |....|
------   |..*...+####+....|
         ---+----    ------
            #
          --+--
          |..=|
          -----